----------------------
|                    |
| xxxxxxx            |
|                    |
|                    |
|                    |
|                    |
|                    |
|                    |
|                    |
|                    |
|               x    |
|                xx  |
|                    |
|                    |
|                    |
|                    |
|                    |
|                    |
|                    |
|                 xxx|
----------------------
EOF
