----------------------
|                    |
|                    |
|                    |
|                    |
|                    |
|          x         |
|                    |
|                    |
|                    |
|                    |
|          R    x    |
|                    |
|                    |
|                    |
|                    |
|          x         |
|                    |
|                    |
|                    |
|                    |
----------------------
EOF
