----------------------
|                    |
|                    |
|                    |
|                    |
|                    |
|                    |
|                    |
|                    |
|                    |
|                    |
|          R         |
|                    |
|                    |
|                    |
|                    |
|          x         |
|                    |
|                    |
|                    |
|                    |
----------------------
EOF
